# - Climate regions according to the Köppen climate classification
# - <climate region> = <notation> <attributes> <possible locations>
# - Info and formula (in English): https://www.britannica.com/science/Koppen-climate-classification

# - Resources on agricultural efficiency: http://sites.tufts.edu/willmasters/files/2010/06/MastersAndWeibe-ClimateAndAgProductivity.pdf
# - efficiency and sizes are estimates here (not much info on ecology of ME avaiable, none in terms of numbers)
# - https://decolonialatlas.wordpress.com/2015/03/11/global-agriculture-where-we-grow-what-we-grow-and-how-we-grow/

# - https://64.media.tumblr.com/6860d4bd5ca674c81d18124955b042da/tumblr_p0bye3T1Pr1ug4fnjo1_1280.jpg

arctic_polar_climate = # EF polar regions
{
	farm_rgo_size = -0.45
	farm_rgo_eff = -0.98
	mine_rgo_size = -0.8
	mine_rgo_eff = -0.6
}

cold_highlands_climate = # Ds warm highland
{
	farm_rgo_size = -0.1
	farm_rgo_eff = -0.05
	mine_rgo_size = 0.3
	mine_rgo_eff = 0.2
}

cold_humid_climate = # Df cold temperate humid
{
	farm_rgo_size = 0.2
	farm_rgo_eff = 0.15
	mine_rgo_size = 0.2
	mine_rgo_eff = 0.1
}

temperate_oceanic_climate = # Cfb/Cfc temperate maritime
{
	farm_rgo_size = 0.4
	farm_rgo_eff = 0.25
	mine_rgo_size = 0.2
	mine_rgo_eff = 0.1
}

temperate_drysummer_climate = # Cs warm dry subtropical
{
	farm_rgo_size = 0.15
	farm_rgo_eff = 0.05
	mine_rgo_size = 0.1
	mine_rgo_eff = 0.1
}

temperate_subtropical_climate = # Cfa warm temperate humid subtropical
{
	farm_rgo_size = 0.5
	farm_rgo_eff = 0.3
	mine_rgo_size = 0.05
	mine_rgo_eff = 0.15
}

arid_cold_climate = # Bsk Cold Deserts
{
	farm_rgo_size = -0.45
	farm_rgo_eff = -0.5
	mine_rgo_size = -0.3
	mine_rgo_eff = -0.2
}

arid_climate = # Bwh Hot Deserts
{
	farm_rgo_size = -0.45
	farm_rgo_eff = -0.95
	mine_rgo_size = -0.3
	mine_rgo_eff = -0.2
	max_attrition = 5
}

semi_arid_climate = # Bsh Hot Steppes
{
	farm_rgo_size = -0.2
	farm_rgo_eff = -0.4
	mine_rgo_size = -0.05
	mine_rgo_eff = -0.1
	max_attrition = 3
}

cold_highlands_climate = {
	1 5 6 12 18 22 30 
	31 54 55 56 71 72 73 74 75 76 86 91 94 100 109 116 396 400 402 403 406 407 408 431 432 433 434 435 436 437 438 439 440 450 
	451 452 453 454 455 551 552 553 554 555 556 614 667 668 669 670 671 673 674 676 677 678 679 681 682 683 684 685 686 687 688 689 788 789 790 795 796 797 798 806 807 812 813 842 843 844 845 846 847 848 849 850 851 917 918 919 920 942 943 944 945 946 947 968 969 970 971 986 987 993 994 995 999 
}

temperate_drysummer_climate = {
	2 3 4 7 8 9 10 11 13 14 15 16 17 19 20 21 23 24 25 26 27 28 29 32 33 35 36 37 39 41 42 43 44 45 46 47 48 49 50 51 52 53 57 58 60 
	62 63 65 66 69 70 77 78 79 80 81 82 83 84 85 87 88 89 92 93 96 97 98 101 102 103 104 105 107 110 112 113 114 115 117 118 119 120 
	121 122 123 124 125 126 127 128 129 130 131 132 133 134 135 136 137 138 139 140 141 142 143 144 145 146 147 148 149 150 
	151 152 153 154 155 156 157 158 159 160 162 163 164 165 166 198 199 200 201 202 203 204 205 206 207 208 209 210 
	211 212 213 214 215 216 217 218 219 220 221 222 223 224 225 226 227 228 229 230 231 232 233 234 235 236 237 238 239 240 
	241 242 243 244 245 246 247 248 249 250 251 252 253 254 255 256 263 269 270 
	285 288 289 560 561 562 563 564 565 566 778 779 780 
	781 782 783 784 785 786 787 791 792 793 794 799 800 801 802 803 804 805 
}

arctic_polar_climate = {
	34 40 59 61 64 67 68 90 
	95 106 108 111 161 185 1042 1043 1044 1045 1046 1047 1048 1049 1050 
	1051 1052 1053 1054 1055 1056 1057 1058 1059 1060 1061 1062 1063 1064 1065 
}

temperate_oceanic_climate = {
	38 99 172 173 174 175 176 177 184 186 187 188 189 190 192 194 195 196 197 808 809 810 
	811 814 815 816 817 818 819 820 821 822 823 824 825 826 827 828 829 830 831 832 833 834 835 836 837 838 839 840 
	841 861 862 863 864 865 866 867 868 869 870 
	871 872 873 874 875 876 877 878 879 880 881 882 883 884 885 886 887 888 889 890 891 892 893 894 895 896 897 898 899 900 
	901 902 903 904 905 906 907 908 909 910 911 912 913 914 915 916 921 922 923 924 925 926 927 928 929 930 
	931 932 933 934 935 936 937 938 939 940 941 948 949 950 951 952 953 954 955 956 957 958 959 960 
	961 962 963 
}

temperate_subtropical_climate = {
	167 168 169 170 171 178 180 
	181 182 183 
}

cold_humid_climate = {
	179 191 193 456 457 458 459 460 461 462 463 464 465 466 467 468 469 470 471 472 473 474 475 476 477 478 479 480 
	481 482 483 484 485 486 487 488 489 490 491 492 493 494 495 496 497 498 499 500 501 502 503 504 505 506 507 508 509 510 
	511 512 513 514 515 516 517 518 519 520 521 522 523 524 525 526 527 528 529 530 531 532 533 534 535 536 537 538 539 540 
	541 542 543 544 545 546 547 548 549 550 557 558 559 567 568 569 570 
	571 572 573 574 575 576 577 578 579 580 581 582 583 584 585 592 593 594 596 597 598 599 600 
	601 602 603 604 605 606 607 608 609 610 611 612 613 615 616 617 618 619 620 621 622 623 624 625 626 627 628 629 630 
	631 632 633 634 635 636 637 638 639 640 641 642 643 644 645 646 647 648 649 650 651 652 653 654 655 656 657 658 659 660 
	661 662 663 664 665 666 672 675 680 690 
	691 692 693 694 695 696 697 698 699 700 701 702 703 704 705 706 707 708 709 710 711 712 713 714 715 716 717 718 719 720 
	721 722 723 724 725 726 727 728 729 730 731 732 733 734 735 736 737 738 739 740 741 742 743 744 745 746 747 748 749 750 
	751 752 753 754 755 756 757 758 759 760 761 762 763 764 765 766 767 768 769 770 771 772 773 774 775 776 777 852 853 854 855 856 857 858 859 860 964 965 966 967 972 973 974 975 976 977 978 979 980 981 982 983 984 985 988 989 990 
	991 992 996 997 998 1000 1001 1002 1003 1004 1005 1006 1007 1008 1009 1010 1011 1012 1013 1014 1015 1016 1017 1018 1019 1020 
	1021 1022 1023 1024 1025 1026 1027 1028 1029 1030 1031 1032 1033 1034 1035 1036 1037 1038 1039 1040 1041 
}

arid_cold_climate = {
	257 258 259 260 261 262 264 265 266 267 268 271 272 273 274 276 277 278 279 280 281 282 283 284 
}

arid_climate = {
	275 313 314 315 316 317 318 319 320 321 322 323 324 325 326 327 328 329 330 
	331 332 333 358 361 368 369 370 371 421 422 423 424 425 426 427 428 429 430 441 442 443 444 445 446 447 448 449 
}

semi_arid_climate = {
	286 287 290 291 292 293 294 295 296 297 298 299 300 
	301 302 303 304 305 306 307 308 309 310 311 312 334 335 336 337 338 339 340 341 342 343 344 345 346 347 348 349 350 351 352 353 354 355 356 357 359 360 
	362 363 364 365 366 367 372 373 374 375 376 377 378 379 380 381 382 383 384 385 386 387 388 389 390 
	391 392 393 394 395 397 398 399 401 404 405 409 410 411 412 413 414 415 416 417 418 419 420 
	586 587 588 589 590 591 595 
}
