temperate_subtropical_climate_hills = {
	169 180
}

arid_climate_hills = {
	275 313 315 317 318 319 320 321 322 323 324 325 326 327 328 329 330 331 332 333 358 361 369 370 371 421 422 423 424 427
	428 429 430 441 443 444 447 448 449
}

temperate_subtropical_climate_plains = {
	168 170 171 182 183
}

arid_cold_climate_plains = {
	257 258 259 267 271 273 274 276
}

temperate_oceanic_climate_plains = {
	40 59 64 90 95 99 106 108 111 125 137 161 172 174 175 177 184 185 186 189 190 192 197 217 224 237 245 281 316 445
	450 808 809 810 811 814 816 817 818 819 820 822 823 824 826 827 828 829 830 831 832 833 834 835 836 837 838 840 861 863
	864 865 867 868 869 871 872 873 874 875 876 877 878 879 880 881 883 886 887 888 889 890 891 892 893 894 895 896 897 898
	899 901 902 905 906 907 908 910 912 914 915 920 921 922 929 930 931 935 936 937 938 939 940 941 946 948 949 951 952 953
	954 955 957 958 1149 1150 1151 1152 1153 1177 1178 1179 1180 1181 1182 1183 1184 1186 1188 1189 1192 1193 1194 1195 1196 1204 1205 1207 1212 1213
	1214 1215 1216 1217 1218 1219 1220 1221 1223 1224 1225 1226 1227 1228 1229 1230 1231 1232 1233 1234 1235 1236 1237 1238 1239 1240 1241 1242 1243 1247
	1248 1249 1250 1447 1448 1449 1452 1453 1454 1455 1456 1457 1458 1460 1461 1462 1463 1464 1465 1469 1470 1471
}

temperate_subtropical_climate_woods = {
	167 178 181
}

temperate_oceanic_climate_hills = {
	34 61 131 194 296 815 866 870 882 884 903 904 911 913 916 918 924 925 926 927 928 932 933 934 956 960 961 962 963 1185
	1187 1190 1191 1197 1198 1199 1200 1201 1202 1203 1206 1208 1209 1210 1211 1222 1245 1246
}

arctic_polar_climate_hills = {
	1042 1043 1044 1045 1046 1047 1048 1049 1050 1051 1052 1053 1054 1055 1056 1057 1058 1059 1060 1061 1062 1063 1064 1065
}

temperate_drysummer_climate_hills = {
	10 29 57 58 60 62 63 65 66 69 71 77 80 83 88 92 107 112 117 121 123 135 150 152 153 156 158 159 166 202
	203 207 215 218 221 222 223 230 235 241 243 244 246 247 248 249 250 251 253 254 263 560 563 564 783 784 795 798
}

cold_highlands_climate_hills = {
	54 55 56 72 73 74 75 76 100 110 116 151 252 279 291 400 403 406 407 408 425 431 432 433 434 435 436 437 438 439
	440 452 453 454 455 551 555 556 614 667 669 670 671 676 678 679 681 682 684 796 797 812 813 841 842 843 844 845 846 847
	848 849 850 851 917 919 942 947 968 969 970 971 993 1160 1161 1162 1163 1165 1166 1167 1443 1444 1445 1446
}

temperate_drysummer_climate_plains = {
	1 3 4 5 6 7 8 9 12 13 14 15 16 17 18 19 20 21 22 23 24 25 26 27 28 30 31 32 33 35
	36 39 41 42 43 44 45 46 47 48 49 50 51 52 53 78 79 81 82 84 85 86 89 91 93 94 96 97 98 101
	102 104 105 109 114 115 118 119 120 122 129 130 132 133 134 138 139 142 143 144 146 149 154 160 163 164 165 198 204 205
	206 208 209 210 211 212 213 214 216 219 220 225 226 227 228 229 231 232 233 234 236 238 239 240 242 256 270 285 288 289
	372 561 562 565 566 683 779 780 781 782 785 786 788 789 790 791 793 794 799 800 801 802 803 804 805 806 807 1171 1172 1173
	1174 1175 1176
}

cold_humid_climate_woods = {
	498 509 531 538 547 596 604 605 625 628 629 643 661 673 685 690 691 692 693 694 695 696 697 698 699 700 701 702 704 705
	706 707 708 709 710 711 712 713 714 715 716 717 718 719 720 721 722 723 724 725 726 732 745 753 763 764 765 766 770 771
	772 773 860 974 1038 1251 1252 1280 1316 1339 1357 1400 1401 1402 1403 1426 1427 1428 1429 1430 1431 1432 1433 1434 1435 1436
}

temperate_oceanic_climate_woods = {
	38 67 68 124 136 173 176 187 188 195 196 314 821 825 839 862 885 900 909 923 950 959 1244 1450 1451 1459 1466 1467 1468 1472
}

arid_cold_climate_hills = {
	260 261 262 268 278 280 282 283 284 426
}

semi_arid_climate_plains = {
	286 287 292 295 297 299 302 303 305 309 310 311 312 334 335 336 338 339 340 343 347 348 350 351 352 353 354 356 357 359
	360 362 363 373 374 378 379 381 382 387 388 389 390 391 393 394 395 397 398 399 401 404 405 409 410 411 412 413 414 415
	416 417 418 419 420
}

arid_cold_climate_woods = {
	264 265 266 272
}

cold_highlands_climate_plains = {
	402 668 686 687 688
}

cold_humid_climate_plains = {
	126 127 140 141 145 148 277 349 365 442 451 456 457 458 459 460 461 462 463 464 467 469 470 471 472 474 475 476 477 478
	480 481 482 483 485 486 487 489 490 491 492 493 494 495 496 499 500 501 503 504 505 506 507 508 510 511 514 516 517 518
	523 524 525 526 527 529 530 532 534 535 536 537 539 540 541 542 543 544 545 552 553 554 557 558 567 568 569 570 571 572
	573 574 575 579 582 583 585 593 597 598 599 600 602 606 607 610 611 612 613 618 619 620 621 622 623 626 627 630 631 633
	634 635 636 637 640 641 644 646 647 648 649 650 651 652 653 654 655 656 657 658 662 663 665 666 674 675 677 689 728 729
	730 731 733 734 735 736 737 739 740 741 742 743 744 746 747 748 749 750 751 754 755 756 757 758 759 760 761 762 767 768
	769 774 775 778 859 944 972 973 975 976 977 978 979 982 983 985 986 994 996 997 998 1001 1002 1003 1004 1005 1006 1007 1008 1009
	1010 1011 1012 1013 1014 1020 1021 1022 1025 1026 1028 1029 1032 1033 1034 1035 1036 1037 1039 1040 1041 1168 1169 1253 1254 1255 1256 1257 1258 1259
	1267 1268 1269 1270 1271 1272 1273 1274 1275 1276 1277 1281 1282 1283 1284 1285 1286 1287 1288 1289 1290 1291 1292 1293 1294 1295 1296 1297 1298 1299
	1300 1301 1302 1303 1304 1305 1306 1307 1308 1309 1310 1311 1312 1313 1314 1315 1325 1326 1327 1328 1329 1330 1331 1332 1333 1334 1335 1336 1337 1338
	1340 1341 1342 1343 1344 1345 1346 1348 1349 1350 1351 1352 1353 1354 1355 1356 1358 1359 1360 1361 1362 1363 1364 1365 1366 1367 1368 1377 1379 1380
	1381 1382 1383 1384 1385 1386 1387 1388 1391 1392 1393 1394 1395 1396 1399 1404 1405 1406 1407 1408 1409 1410 1411 1412 1413 1414 1415 1416 1417 1418
	1419 1420 1421 1422 1423 1437 1438 1439 1440 1441 1442 1473 1474
}

temperate_drysummer_climate_woods = {
	2 11 37 70 87 103 113 128 155 157 162 199 200 201 787 792
}

semi_arid_climate_hills = {
	255 290 293 294 298 300 301 304 306 308 337 341 342 344 345 346 364 366 367 368 375 376 377 380 383 384 385 386 392 586
	587 588 589 590 591 595
}

cold_humid_climate_hills = {
	147 179 191 193 269 307 355 396 446 465 466 468 473 479 484 488 497 502 512 513 515 519 520 521 522 528 533 546 548 549
	550 559 576 577 578 580 581 584 592 594 601 603 608 609 615 616 617 624 632 638 639 642 645 659 660 664 672 680 703 727
	738 752 776 777 852 853 854 855 856 857 858 943 945 964 965 966 967 980 981 984 987 988 989 990 991 992 995 999 1000 1015
	1016 1017 1018 1019 1023 1024 1027 1030 1031 1154 1155 1156 1157 1158 1159 1170 1260 1261 1262 1263 1264 1265 1266 1278 1279 1317 1318 1319 1320 1321
	1322 1323 1324 1347 1369 1370 1371 1372 1373 1374 1378 1389 1390 1397 1398 1424 1425 1475
}

