arctic_polar_climate = {
	127 1042 1043 1044 1045 1046 1047 1048 1049 1050 1051 1052 1053 1054 1055 1056 1057 1058 1059 1060 1061 1062 1063 1064 1065
}

cold_highlands_climate = {
	54 55 56 71 72 73 74 75 76 86 100 110 116 151 252 279 291 400 402 403 406 407 408 425 431 432 433 434 435 436
	437 438 439 440 452 453 454 455 551 552 553 554 555 556 614 667 668 669 670 671 676 678 679 681 682 684 685 686 687 688
	796 797 812 813 842 843 844 845 846 847 848 849 850 851 917 919 942 947 968 969 970 971 986 987 993 994 995 999 1160 1161
	1162 1163 1165 1166 1167
}

arid_climate = {
	275 313 315 317 318 319 320 321 322 323 324 325 326 327 328 329 330 331 332 333 358 361 369 370 371 421 422 423 424 426
	427 428 429 430 441 443 444 447 448 449
}

cold_humid_climate = {
	126 140 141 145 147 148 179 191 193 269 277 349 355 396 442 446 451 456 457 458 459 460 461 462 463 464 465 466 467 468
	469 470 471 472 473 474 475 476 477 478 479 480 481 482 483 484 485 486 487 488 489 490 491 492 493 494 495 496 497 498
	499 500 501 502 503 504 505 506 507 508 509 510 511 512 513 514 515 516 517 518 519 520 521 522 523 524 525 526 527 528
	529 530 531 532 533 534 535 536 537 538 539 540 541 542 543 544 545 546 547 548 549 550 557 558 559 567 568 569 570 571
	572 573 574 575 576 577 578 579 580 581 582 583 584 585 592 593 594 596 597 598 599 600 601 602 603 604 605 606 607 608
	609 610 611 612 613 615 616 617 618 619 620 621 622 623 624 625 626 627 628 629 630 631 632 633 634 635 636 637 638 639
	640 641 642 643 644 645 646 647 648 649 650 651 652 653 654 655 656 657 658 659 660 661 662 663 664 665 666 672 673 674
	675 677 680 689 690 691 692 693 694 695 696 697 698 699 700 701 702 703 704 705 706 707 708 709 710 711 712 713 714 715
	716 717 718 719 720 721 722 723 724 725 726 727 728 729 730 731 732 733 734 735 736 737 738 739 740 741 742 743 744 745
	746 747 748 749 750 751 752 753 754 755 756 757 758 759 760 761 762 763 764 765 766 767 768 769 770 771 772 773 774 775
	776 777 778 852 853 854 855 856 857 858 859 860 943 944 945 964 965 966 967 972 973 974 975 976 977 978 979 980 981 982
	983 984 985 988 989 990 991 992 996 997 998 1000 1001 1002 1003 1004 1005 1006 1007 1008 1009 1010 1011 1012 1013 1014 1015 1016 1017 1018
	1019 1020 1021 1022 1023 1024 1025 1026 1027 1028 1029 1030 1031 1032 1033 1034 1035 1036 1037 1038 1039 1040 1041 1154 1155 1156 1157 1158 1159 1168
	1169 1170
}

temperate_drysummer_climate = {
	1 2 3 4 5 6 7 8 9 10 11 12 13 14 15 16 17 18 19 20 21 22 23 24 25 26 27 28 29 30
	31 32 33 35 36 37 39 41 42 43 44 45 46 47 48 49 50 51 52 53 57 58 60 62 63 65 66 69 70 77
	78 79 80 81 82 83 84 85 87 88 89 91 92 93 94 96 97 98 101 102 103 104 105 107 109 112 113 114 115 117
	118 119 120 121 122 123 128 129 130 132 133 134 135 138 139 142 143 144 146 149 150 152 153 154 155 156 157 158 159 160
	162 163 164 165 166 198 199 200 201 202 203 204 205 206 207 208 209 210 211 212 213 214 215 216 218 219 220 221 222 223
	225 226 227 228 229 230 231 232 233 234 235 236 238 239 240 241 242 243 244 246 247 248 249 250 251 253 254 256 263 270
	285 288 289 372 560 561 562 563 564 565 566 683 779 780 781 782 783 784 785 786 787 788 789 790 791 792 793 794 795 798
	799 800 801 802 803 804 805 806 807 1171 1172 1173 1174 1175 1176
}

arid_cold_climate = {
	257 258 259 260 261 262 264 265 266 267 268 271 272 273 274 276 278 280 282 283 284
}

temperate_subtropical_climate = {
	167 168 169 170 171 178 180 181 182 183
}

temperate_oceanic_climate = {
	34 38 40 59 61 64 67 68 90 95 99 106 108 111 124 125 131 136 137 161 172 173 174 175 176 177 184 185 186 187
	188 189 190 192 194 195 196 197 217 224 237 245 281 296 307 314 316 365 445 450 808 809 810 811 814 815 816 817 818 819
	820 821 822 823 824 825 826 827 828 829 830 831 832 833 834 835 836 837 838 839 840 841 861 862 863 864 865 866 867 868
	869 870 871 872 873 874 875 876 877 878 879 880 881 882 883 884 885 886 887 888 889 890 891 892 893 894 895 896 897 898
	899 900 901 902 903 904 905 906 907 908 909 910 911 912 913 914 915 916 918 920 921 922 923 924 925 926 927 928 929 930
	931 932 933 934 935 936 937 938 939 940 941 946 948 949 950 951 952 953 954 955 956 957 958 959 960 961 962 963 1149 1150
	1151 1152 1153
}

semi_arid_climate = {
	255 286 287 290 292 293 294 295 297 298 299 300 301 302 303 304 305 306 308 309 310 311 312 334 335 336 337 338 339 340
	341 342 343 344 345 346 347 348 350 351 352 353 354 356 357 359 360 362 363 364 366 367 368 373 374 375 376 377 378 379
	380 381 382 383 384 385 386 387 388 389 390 391 392 393 394 395 397 398 399 401 404 405 409 410 411 412 413 414 415 416
	417 418 419 420 586 587 588 589 590 591 595
}

