max_provinces = 732

sea_starts = {
	551 552 553 554 555
	556 557 558 559 560 561 562 563 564 565 566 567 568 569 570 571 572 573 574 575 576 577 578 579 580 581 582 583 584 585 586 587 588 589 590 591 592 593 594 595 596 597 598 599 600 601 602 603 604 605
	606 607 608 609 610 611 612 613 614 615 616 617 618 619 620 621 622 623 624 625 626 627 628 629 630 631 632 633 634 635 636 637 638 639 
	640 641 642 643 644 645 646 647 648 649 650 651 652 653 654 655 656 657 658 659 660 661 662 663 664 665 666 667 668 669 670 671 672 673 674 675 676 677 678 679 680 681 682 683 684 685 686 687 688 689 
	690 691 692 693 694 695 696 697 698 699 700 701 702 703 704 705 706 707 708 709 710 711 712 713 714 715 716 717 718 719 720 721 722 723 
	724 725 726 727 728 729 730 731
}

#definitions = "definition.csv"    
definitions = "../mod/LOTR/map/definition.csv"
provinces = "provinces.bmp"
positions = "positions.txt"
terrain = "terrain.bmp"
rivers = "rivers.bmp"
terrain_definition = "terrain.txt"
tree_definition = "trees.txt"
continent = "continent.txt"
adjacencies = "adjacencies.csv"
region = "region.txt"
region_sea = "region_sea.txt"
province_flag_sprite = "province_flag_sprites"


border_heights = {
	500
	800
	1100
}

terrain_sheet_heights = {
	500 #150
}

tree = 350

border_cutoff = 1100.0

